1 1 1 1 1 0 5 5 5 5 5 5 5 5 5 5
1 3 3 3 1 0 0 0 0 0 0 0 0 0 0 0
1 3 3 3 3 3 3 3 3 3 3 3 3 3 3 3
1 3 3 3 3 3 3 3 3 3 3 3 3 3 3 3
1 3 3 3 1 0 0 0 0 0 0 0 0 0 0 0
1 1 1 1 1 0 0 0 0 0 0 0 0 5 5 5
0 0 0 0 0 0 0 0 0 0 0 0 0 5 5 5
4 4 0 0 0 0 0 0 0 0 0 0 0 5 5 5
2 4 4 4 4 0 0 0 0 0 0 0 0 5 5 5
2 2 2 2 4 4 4 0 0 0 0 0 0 5 5 5
2 2 2 2 2 2 4 4 0 0 0 0 0 5 5 5
2 2 2 2 2 2 2 4 0 0 0 0 0 5 5 5